90-tih	?
brainer	?
čepo	?
christianitatis	?
donbasu	?
garevcu	?
gvozdanskog	?
lauper	?
ormaruše	?
aha	da
Alojzije	da
Basariček	da
Berislaviću	da
bl	da
blažene	da
bolesno	da
Bombardirovića	da
Bombardirovići	da
Borovčak	da
bratovu	da
Bulešić	da
Burića	da
carinikov	da
carinjenih	da
Charlie	da
ćirilično	da
cug	da
daj	da
dali	da
dan	da
dana	da
danu	da
dao	da
demgagogije	da
direktno	da
Dnjepra	da
donijeti	da
Donjecka	da
drugove	da
drugovi	da
dva	da
dvadesetog	da
fra	da
gasmaska	da
gasmasku	da
geniju	da
gospodinova	da
Herodu	da
horde	da
Hrastovice	da
i	da
ikakve	da
institucionaliziranog	da
Ivasić	da
iz	da
izložiti	da
izluđene	da
izvjesnim	da
jedan	da
jedna	da
jedni	da
jednih	da
jednim	da
jedno	da
jednog	da
jednoj	da
jednome	da
kad	da
kada	da
kakva	da
kakve	da
kakvog	da
kakvu	da
Kičmanović	da
Kičmanovići	da
kontraimperijalizma	da
kontrarevolucionare	da
Kordića	da
krajnje	da
krije	da
kriju	da
Kristove	da
Krležinoj	da
kulturocid	da
Latinovicz	da
luganska	da
mala	da
male	da
malim	da
malo	da
malu	da
manjeg	da
materinjeg	da
materinji	da
Milićević	da
Milićevića	da
minornu	da
mladi	da
mladih	da
moja	da
mojoj	da
motorna	da
mučenice	da
mučeničke	da
na	da
najbržem	da
najprogonjenija	da
najubijanija	da
naš	da
naša	da
naše	da
našeg	da
našega	da
naši	da
naših	da
našim	da
našoj	da
nastavnikov	da
našu	da
ne	da
nečitanju	da
negativizam	da
neke	da
neki	da
neko	da
neocarinjenu	da
neokomunizam	da
neproglašene	da
nepropuštenih	da
neraskidivost	da
nestabilnija	da
nevina	da
nevinim	da
nevinu	da
nikakav	da
nikakvu	da
njegova	da
njegove	da
njegovo	da
njegovoj	da
njegovu	da
njen	da
njezine	da
njezinu	da
njihov	da
njihova	da
njihove	da
njihovu	da
no	da
npr	da
oba	da
Obama	da
Odesi	da
odnosom	da
oligarsima	da
onaj	da
one	da
onih	da
onim	da
onima	da
onoga	da
onoj	da
onom	da
onu	da
opaki	da
općedruštveni	da
osamdesetih	da
osim	da
ovaj	da
ove	da
ovim	da
ovo	da
ovog	da
ovoga	da
ovom	da
ovu	da
petnaestogodišnjaku	da
piromana	da
pjesnikovo	da
plamena	da
počela	da
počinila	da
počinili	da
počinio	da
počnu	da
pohrvaćenja	da
poobarala	da
poradi	da
postapokaliptičke	da
postapokaliptičkih	da
postmoderno	da
potjeranim	da
prebendari	da
predziđe	da
prekoračitelja	da
pristane	da
prisutnike	da
progonjenog	da
promijeni	da
promijenio	da
propatile	da
protjeruje	da
puno	da
Pupačića	da
Pupačićeva	da
Pupačićevu	da
put	da
Putinovi	da
putu	da
rakovičkoj	da
razoružanih	da
Robin	da
Rudimira	da
sam	da
sama	da
same	da
sami	da
samim	da
samima	da
samu	da
sazori	da
sekulariziranog	da
sineastički	da
širokobriješki	da
sjeverne	da
sjevernog	da
sjevernoga	da
skupu	da
Slamniga	da
slobodni	da
službenice	da
Sorkočevića	da
st	da
stanovima	da
subraće	da
susestre	da
sv	da
svednevice	da
svjesni	da
svog	da
svoga	da
svoj	da
svoje	da
svojega	da
svojih	da
svojim	da
svojoj	da
svojom	da
svoju	da
svom	da
svome	da
taj	da
takav	da
tako	da
takvi	da
takvih	da
takvim	da
takvog	da
takvoj	da
takvu	da
Tavelić	da
te	da
tog	da
tomu	da
ubijajući	da
učiniti	da
Udbe	da
Udbine	da
Udbini	da
uključujući	da
urbanocid	da
uznemirujuća	da
vestu	da
violinističkom	da
vjerničkog	da
w	da
zaboravio	da
zaboravite	da
zaboraviti	da
zahtijevajući	da
zahvaljujući	da
zar	da
zato	da
zavapimo	da
Zrina	da
žvaka	da
–    GRESKA	ne
%	ne
(kopti)	ne
(oko	ne
0,6	ne
1	ne
10	ne
13	ne
15	ne
1519	ne
1578	ne
160	ne
1671	ne
17	ne
1871	ne
1928	ne
1943	ne
1945	ne
1972.	ne
1975	ne
1980	ne
2	ne
20	ne
200	ne
2003	ne
2014	ne
2014.	ne
208	ne
224	ne
23	ne
250	ne
30	ne
32	ne
40	ne
400	ne
45	ne
45-godišnje	ne
5	ne
50	ne
6	ne
65	ne
66	ne
67	ne
7	ne
800	ne
9	ne
ajatola	ne
antemurale	ne
anticristiana	ne
anti-radničke	ne
anti-raketnog	ne
azovske	ne
b	ne
bakhdida	ne
cindy	ne
counta	ne
csto	ne
curriculum	ne
dobaljudskih	ne
end	ne
europi,    GRESKA	ne
faking	ne
fidei	ne
hannibal	ne
hollande	ne
hummungus	ne
humungus	ne
in	ne
indagine	ne
jinping	ne
korijena.    GRESKA	ne
lecter	ne
maidan	ne
manson	ne
martirio	ne
mosula	ne
myers	ne
nav	ne
nel	ne
nrd-u	ne
nrl-u	ne
nuovi	ne
nuovo	ne
o.g.	ne
odium	ne
para-nomenklaturi	ne
perseguitati	ne
polu-članica	ne
porošenka	ne
posto)	ne
poznavateljom	ne
propagandno-medijski	ne
pro-ruskog	ne
raffael	ne
remake	ne
rock\'n\'rolla	ne
sbperiskop	ne
secolo	ne
sirsko-katoličkoj	ne
sirsko-pravoslavnoj	ne
sloboda.    GRESKA	ne
socci	ne
soccija	ne
soccijeva	ne
sull’intolleranza	ne
the	ne
tusk	ne
voorhees	ne
zrtve	ne