Srijema	Srijem	10	imenica
i	i		veznik
balte	balta		imenica
balta	balta		imenica
mladih	mladi		pridjev
tomu	to		zamjenica
ne	ne		èestica
svoje	svoj	138	zamjenica
onima	oni		zamjenica
fermendžinovi	fermendžinovi		ne
Komuloviæa	Komuloviæ	9	imenica
Slavenima	Slaven	16	imenica
osim	osim		prijedlog
ovim	ovaj	106	zamjenica
fermendžin	fermendžin		ne
Komuloviæeva	Komuloviæev	29	pridjev
Komuloviæu	Komuloviæ		imenica
sam	biti	139	glagol
oba	oba		imenica
iz	iz		prijedlog
njegovih	njegov	104	zamjenica
obaju	oba		imenica
na	na		prijedlog
tako	tako		prilog
jedan	jedan		broj
kolonistièkom	kolonistièki	37	pridjev
stipanovac	stipanovac		?
razmeðama	razmeða		imenica
Èikeš	Èikeš	9	imenica
Mezopotamije	Mezopotamija	10	imenica
Dunava	Dunava	10	imenica
terra	terra		ne
incognita	incognita		ne
taj	taj	106	zamjenica
krajièak	krajièak		imenica
svojim	svoj	138	zamjenica
svoga	svoj	138	zamjenica
svojom	svoj	138	zamjenica
slavonsko-podravska	slavonsko-podravska		ne
železnica	železnica		ne
Podravine	Podravina	9	imenica
istorije	istorije		ne
ovoga	ovaj	106	zamjenica
Podravini	Podravina	9	imenica
železnicom	železnicom		ne
prevoznim	prevoznim		ne
gutmanni	gutmanni		ne
posedovali	posedovali		ne
eksploatisali	eksploatisali		ne
gutmannovih	gutmannovih		ne
retko	retko		ne
malo	malo		prilog
odeæu	odeæu		ne
železnièkih	železnièkih		ne
finansija	finansija		ne
puno	puno		prilog
velikomaðarskoj	velikomaðarski	28	pridjev
odnosa	odnos		imenica
južnopodunavski	južnopodunavski	28	pridjev
istoènohrvatskog	istoènohrvatski	28	pridjev
južnodunavskog	južnodunavski	28	pridjev
južnopodunavskog	južnopodunavski	28	pridjev
maðarske	maðarski	28	pridjev
njegovom	njegov	104	zamjenica
promaðarski	promaðarski	28	pridjev
opismenjavanju	opismenjavanje		imenica
neke	neki		zamjenica
hrabaka	hrabaka		ne
hrabaku	hrabaku		ne
tamaš	tamaš		ne
ðura	ðura		?
hardi	hardi		ne
umetnosti	umetnosti		ne
neki	neki		zamjenica
istoriografiju	istoriografiju		ne
južnoslovenske	južnoslovenske		ne
istoriografije	istoriografije		ne
izbegavao	izbegavao		ne
manir	manir		ne
delovanja	delovanja		ne
te	te		veznik
težaka	težak		imenica
hrabak	hrabak		ne
uèinio	uèiniti		glagol
uveliko	uveliko		prilog
podseæaju	podseæaju		ne
Katanèiæevu	Katanèiæev	29	pridjev
uopšte	uopšte		ne
nauènost	nauènost		ne
neizmerljivu	neizmerljivu		ne
vrednost	vrednost		ne
predlozi	predlozi		ne
železnièke	železnièke		ne
zakasnelo	zakasnelo		ne
formulisanje	formulisanje		ne
kalvinske	kalvinske		ne
franciscana	franciscana		ne
kad	kad		prilog
istvna	istvna		ne
bocskaya	bocskaya		ne
neko	neki		zamjenica
studia	studia		ne
historica	historica		ne
tyrnaviensia	tyrnaviensia		ne
Trnava	Trnava	10	imenica
njezina	njezin	104	zamjenica
našièko-orahovièko-slatinski	našièko-orahovièko-slatinski		ne
ðakovaèko-osjeèki	ðakovaèko-osjeèki		ne
požeško-pakraèko-daruvarski	požeško-pakraèko-daruvarski		ne
iloèko-vukovarski	iloèko-vukovarski		ne
svojih	svoj	138	zamjenica
hrvatsko-slavonsku	hrvatsko-slavonsku		ne
manja	manji	46	pridjev
zahvaljujuæi	zahvaljujuæi		prilog
svojoj	svoj	138	zamjenica
njegovi	njegov	104	zamjenica
mali	mali		pridjev
Tuzle	Tuzla	10	imenica
Trnave	Trnava	10	imenica
nemuštog	nemušti		pridjev
samoga	sami		pridjev
nasušno	nasušni		pridjev
svoja	svoj	138	zamjenica
sveuèilišnoprofesorsko	sveuèilišnoprofesorski	28	pridjev
put	put		imenica
svoj	svoj	138	zamjenica
CV	CV		kratica
kadra	kadar		imenica
baltu	balta		imenica
naše	naš	104	zamjenica
kakve	kakav		zamjenica
sukrivnje	sukrivnja		imenica
baltinim	baltin		pridjev
no	no		veznik
same	sami		pridjev
kojekakvim	kojekakvi		pridjev
recenzentske	recenzentski	28	pridjev
baltini	baltin		imenica
takve	takav	138	zamjenica
dana	dan		imenica
ove	ova		zamjenica
promašenim	promašeni		pridjev
inovrsnoj	inovrsni		pridjev
recenzentsku	recenzentski	28	pridjev
takav	takav	138	zamjenica
ikome	itko		zamjenica
koristan	korisni		pridjev
ništenjem	ništenje		imenica
jedna	jedan		broj
njegova	njegov	104	zamjenica
dokuèiti	dokuèiti		glagol
kakav	kakav		zamjenica
nekoj	neki		zamjenica
domaæih	domaæi		pridjev
okrenuo	okrenuti		glagol
njegove	njegov	104	zamjenica
uratke	uradak		imenica
kadar	kadar		imenica
èasopisno	èasopisni		pridjev
samoj	sami		pridjev
kakva	kakav		zamjenica
našim	naš	104	zamjenica
plagijatorska	plagijatorski	28	pridjev
dvijetri	dvijetri		?
baltine	baltin		pridjev
takvom	takav	138	zamjenica
predmnijevanome	predmnijevani		pridjev
nj	nj		kratica
nikakve	nikakav	138	zamjenica
mojim	moj	104	zamjenica
samih	sami		pridjev
naših	naš	104	zamjenica
miroljubiva	miroljubivi		pridjev
kavicu	kavica	32	imenica
ocijenite	ocijeniti		glagol
kada	kada		prilog
suureðujete	suureðivati		glagol
priklonim	prikloniti		glagol
qui	qui		ne
tacet	tacet		ne
consentire	consentire		ne
videtur	videtur		ne
bosnae	bosnae		ne
franciscanae	franciscanae		ne
prepisivaèkih	prepisivaèki	37	pridjev
plagijatorskih	plagijatorski	28	pridjev
štetoèinskih	štetoèinski	28	pridjev
recenzentska	recenzentski	28	pridjev
njihove	njihov	104	zamjenica
izglavila	izglaviti		glagol
njihovim	njihov	104	zamjenica
njihova	njihov	104	zamjenica
samim	sami		pridjev
preoznaèena	preoznaèeni		pridjev
orijentire	orijentir		imenica
zaglupljivanja	zaglupljivanje	52	imenica
ovaj	ovaj	106	zamjenica
baltina	baltin		pridjev
