fraulein	fraulein		ne
kad	kad		veznik
prodana	prodani		pridjev
njezin	njezin		zamjenica
na	na		prijedlog
eutanazijskog	eutanazijski		pridjev
put	put		imenica
i	i		veznik
rapidno	rapidno		prilog
sjeverno	sjeverno		prilog
ne	ne		čestica
life	life		ne
coacha	coach		?
death	death		ne
coach	coach		?
one	ona		zamjenica
lajk	lajk		imenica
manjeviše	manjeviše		?
TV-u	TV		kratica
lajkaju	lajkati		glagol
malog	mali		pridjev
umirućeg	umirućih		pridjev
sami	sam		pridjev
svoj	svoj		zamjenica
njegovom	njegov		zamjenica
bolesnog	bolesni		pridjev
pun	puni		pridjev
trovača	trovač		imenica
njegova	njegov		zamjenica
van	van		prilog
njihovih	njihov		zamjenica
iz	iz		prijedlog
njezinih	njezin		zamjenica
puno	puno		prilog
onoga	onaj		zamjenica
iti	iti		ne
malo	malo		prilog
sama	sam		pridjev
slobodnu	slobodni		pridjev
te	te		veznik
zato	zato		prilog
trzne	trznuti		glagol
njegovi	njegov		zamjenica
okreneš	okrenuti		glagol
Thanatos	Thanatos		imenica
aktion	aktion		ne
münsterskog	münsterski		pridjev
clemensa	clemensa		?
von	von		?
Galena	Galen		imenica
ovaj	ovaj		zamjenica
eutanazijski	eutanazijski		pridjev
kadar	kadar		imenica
Hitlerov	Hitlerov		pridjev
mladi	mladi		pridjev
pr	pr		kratica
kakva	kakav		zamjenica
njihovim	njihov		zamjenica
ispred	ispred		prijedlog
sadu	sadu		ne
mainstream	mainstream		?
volk	volk		ne
pursuit	pursuit		ne
of	of		ne
happines	happines		ne
sv	sv		kratica
sedamdesetih	sedamdeseti		pridjev
svjesnih	svjesni		pridjev
no	no		?
elem	elem		veznik
uljuđenih	uljuđeni		pridjev
uložili	uložiti		glagol
tako	tako		prilog
aidindying	aidindying		ne
with	with		ne
dignity	dignity		ne
skončavanju	skončavanje		imenica
end	end		ne
gentle	gentle		ne
landing	landing		ne
onima	oni		zamjenica
exit	exit		ne
svoje	svoj		zamjenica
asistiranu	asistirani		pridjev
assisted	assisted		ne
Quebecu	Quebec		imenica
in	in		ne
kada	kada		prilog
izrežirani	izrežirani		pridjev
pratchetta	pratchetta		?
Alzheimerove	Alzheimerov		pridjev
potpomognutu	potpomognuti		pridjev
bbca	bbca		ne
našim	naš		zamjenica
našoj	naša		zamjenica
pratchett	pratchett		?
Robinsona	Robinsona		imenica
sam	samim		pridjev
zaiskri	zaiskriti		glagol
predumirući	predumirući		pridjev
smješka	smješkati		glagol
saharinskim	saharinski		pridjev
humorom	humor		imenica
mojem	moj		zamjenica
bolesna	bolesni		pridjev
griffiths	griffiths		?
svoju	svoj		zamjenica
svojoj	svoj		zamjenica
svojim	svoj		zamjenica
jedna	jedan		pridjev
dana	dan		imenica
dignitas	dignitas		ne
rowrowrow	rowrowrow		ne
the	the		ne
boat	boat		ne
nižepotpisani	nižepotpisani		pridjev
ove	ovaj		zamjenica
nikakvu	nikakav		zamjenica
osim	osim		prijedlog
fakte	fakt		imenica
neke	neki		zamjenica
umirućih	umirući		pridjev
asistiranog	asistirani		pridjev
svojom	svoj		zamjenica
onih	oni		zamjenica
dati	dati		glagol
kakvu	kakav		zamjenica
opa	opa		?
njezino	njezin		zamjenica
metastazira	metastazirati		glagol
zrelog	zreli		pridjev
ispadnu	ispasti		glagol
negoli	negoli		veznik
els	els		?
borst	borst		ne
verhagen	verhagen		ne
neki	neki		zamjenica
slijedeća	slijedeća		ne
takav	takav		zamjenica
njihove	njihov		zamjenica
obvezujući	obvezujući		pridjev
općevažeća	općevažeći		pridjev
slippery	slippery		ne
slope	slope		ne
primijeniti	primijeniti		glagol
brainer	brainer		ne
Sofijin	Sofijin		pridjev
samim	sami		pridjev
svog	svoj		zamjenica
škartiranju	škartiranje		imenica
slijedeću	slijedeću		ne
višak	višak		imenica
bioetičara	bioetičar		imenica
Singera	Singer		imenica
bolesno	bolesni		pridjev
licentia	licentia		ne
poetica	poetica		ne
male	mali		pridjev
nikakvog	nikakav		zamjenica
učiniti	učiniti		glagol
kakav	kakav		zamjenica
styronovog	styronovog		ne
Sofijinog	Sofijin		pridjev
shoping	shoping		ne
styronovoj	styronovoj		ne
njezine	njezin		zamjenica
njihov	njihov		zamjenica
eutanazijska	eutanazijski		pridjev
uznemirujuće	uznemirujući		pridjev
nadilaženje	nadilaženje		imenica
kakvog	kakav		zamjenica
neko	neki		zamjenica
slobodna	slobodni		pridjev
skok	skok		imenica
izdiferencirani	izdiferencirani		pridjev
njegovog	njegov		zamjenica
lajkova	lajk		imenica
promatrajući	promatrajući		prilog
stiče	sticati		glagol
ucijenjenost	ucijenjenost		imenica
ovo	ovaj		zamjenica
onakvim	onakav		zamjenica
ikome	ikome		zamjenica
samima	sami		pridjev
jedno	jedan		pridjev
takvog	takav		zamjenica
vašim	vaš		zamjenica
protuargumenti	protuargument		imenica
jedan	jedan		pridjev
protumoto	protumoto		?
i/ili	i/ili		veznik
odjebi	odjebati		glagol
signo	signo		ne
vinces	vinces		ne
